                    
      WWBBBBWW      
   BBBWWBBBBWWBBBB  
  BBW#WWWWWW#WWWBBBB
  BBAWW##WWWWWWWBBZB
  BBWWWWWWWWWSWWBBBB
  BBBBBBBBBBBBBB    
                    