                    
 BBBBWWWWWWBBWWWWWW 
 B%BBBBBBBBBBBBWWWY 
 BBBWWWWWWWB%BBWWWW 
 BAW#WSBBWWBBBBWWWW 
 BWWWWWWWWWBB%B     
 BBBBBBBB  BBBB     
                  